20,20


R01 = "0 0 0 0 0 0 0 0 0 0 0 0 0 0 0 0 0 0/
R02 = "0 0 0 0 0 0 0 0 0 0 0 0 0 0 0 0 0 0/
R03 = "0 0 0 0 0 0 0 0 0 0 0 0 0 0 0 0 0 0/
R04 = "0 0 0 0 0 0 0 0 0 0 0 0 0 0 0 0 0 0/
R05 = "0 0 0 0 0 0 0 0 0 0 0 0 0 0 0 0 0 0/
R06 = "0 0 0 W 0 0 0 0 0 0 0 0 T 0 0 0 0 0/
R07 = "0 0 0 W 0 0 0 0 0 0 0 0 T 0 0 0 0 0/
R08 = "0 0 0 W 0 0 0 0 0 0 0 0 0 0 0 0 0 0/
R09 = "0 0 0 0 0 0 0 0 0 0 0 0 0 0 0 0 0 0/
R10 = "0 0 0 0 0 0 0 0 W W 0 0 0 0 0 0 0 0/
R11 = "0 0 0 0 0 0 0 0 0 W 0 0 0 0 0 0 0 0/
R12 = "0 0 0 0 0 0 0 0 0 W 0 0 0 0 0 0 0 0/
R13 = "0 0 0 0 0 0 0 0 0 0 0 0 0 0 W 0 0 0/
R14 = "0 0 0 0 0 0 0 0 0 0 0 0 0 0 W 0 0 0/
R15 = "0 0 0 0 0 0 0 0 0 0 0 0 0 0 0 0 0 0/
R16 = "0 0 0 0 0 0 0 0 0 0 0 0 0 0 0 0 0 0/
R17 = "0 0 0 0 0 0 0 0 0 0 0 0 0 0 0 0 0 0/
R18 = "0 0 0 0 0 0 0 0 0 0 0 0 0 0 0 0 0 0/
R19 = "0 0 0 0 0 0 0 0 0 0 0 0 0 0 0 0 0 0/
R20 = "0 0 0 0 0 0 0 0 0 0 0 0 0 0 0 0 0 0/


