20,20

R01 = "W W W W W W W W W W W W W W W W W W W W/
R02 = "W 0 0 0 0 0 0 0 0 0 0 0 0 0 0 0 0 0 0 W/
R03 = "W 0 0 0 0 0 0 0 W W W W W W 0 0 0 0 0 W/
R04 = "W 0 0 0 0 0 W W W W W W W W W 0 0 0 0 W/
R05 = "W 0 0 0 0 W W W W W W W W W W W 0 0 0 W/
R06 = "W 0 0 0 W W W W 0 0 0 0 W W W W 0 0 0 W/
R07 = "W 0 0 0 0 0 0 0 0 0 0 0 W W W W 0 0 0 W/
R08 = "W 0 0 0 0 0 0 0 0 0 0 W W W W 0 0 0 0 W/
R09 = "W 0 0 0 0 0 0 0 0 0 W W W W 0 0 0 0 0 W/
R10 = "W 0 0 0 0 0 0 0 0 W W W W 0 0 0 0 0 0 W/
R11 = "W 0 0 0 0 0 0 0 W W W W 0 0 0 0 0 0 0 W/
R12 = "W 0 0 0 0 0 0 W W W W 0 0 0 0 0 0 0 0 W/
R13 = "W 0 0 0 0 0 W W W W 0 0 0 0 0 0 0 0 0 W/
R14 = "W 0 0 0 0 W W W W W W W W W W W 0 0 0 W/
R15 = "W 0 0 0 0 W W W W W W W W W W W 0 0 0 W/
R16 = "W 0 0 0 0 W W W W W W W W W W W 0 0 0 W/
R17 = "W 0 0 0 0 0 0 0 0 0 0 0 0 0 0 0 0 0 0 W/
R18 = "W 0 0 0 0 0 0 0 0 0 0 0 0 0 0 0 0 0 0 W/
R19 = "W 0 0 0 0 0 0 0 0 0 0 0 0 0 0 0 0 0 0 W/
R20 = "W W W W W W W W W W W W W W W W W W W W/
