20,20

R01 = "W W W W W W W W W W W W W W W W W W W 0/
R02 = "W 0 0 0 0 0 0 0 0 0 0 0 0 0 0 0 0 0 0 0/
R03 = "W 0 0 0 0 0 0 0 0 0 0 0 0 0 0 0 0 0 0 0/
R04 = "W 0 0 0 0 0 0 0 0 0 0 0 0 0 0 0 0 0 0 0/
R05 = "W 0 0 0 0 0 0 0 0 0 0 0 0 0 0 0 0 0 0 0/
R06 = "W 0 0 0 0 0 0 0 0 0 0 0 0 0 0 0 0 0 0 0/
R07 = "W 0 T T T T T T 0 0 0 0 0 T T T T T T 0/
R08 = "W 0 0 0 0 0 0 0 0 0 0 0 0 0 0 0 0 0 0 0/
R09 = "W 0 0 0 0 0 0 0 0 0 0 0 0 0 0 0 0 0 0 0/
R10 = "W 0 0 0 0 0 0 0 0 0 0 0 0 0 0 0 0 0 0 0/
R11 = "W 0 0 0 0 0 0 0 W W W W W 0 0 0 0 0 0 0/
R12 = "W 0 0 0 0 0 0 0 0 0 0 0 0 0 0 0 0 0 0 0/
R13 = "W 0 0 0 0 0 0 0 0 0 0 0 0 0 0 0 0 0 0 0/
R14 = "W 0 0 0 0 0 0 0 0 0 0 0 0 0 0 0 0 0 0 0/
R15 = "W 0 T T T T T T 0 0 0 0 0 T T T T T T 0/
R16 = "W 0 0 0 0 0 0 0 0 0 0 0 0 0 0 0 0 0 0 0/
R17 = "W 0 0 0 0 0 0 0 0 0 0 0 0 0 0 0 0 0 0 0/
R18 = "W 0 0 0 0 0 0 0 0 0 0 0 0 0 0 0 0 0 0 0/
R19 = "W 0 0 0 0 0 0 0 0 0 0 0 0 0 0 0 0 0 0 0/
R20 = "W 0 0 0 0 0 0 0 0 0 0 0 0 0 0 0 0 0 0 0/
